        <td id="LC1" class="blob-code blob-code-inner js-file-line">Monday	Thứ hai</td>
        <td id="LC2" class="blob-code blob-code-inner js-file-line">Thuật Ngữ Tiếng Anh	Thuật Ngữ Tiếng Việt</td>
        <td id="LC3" class="blob-code blob-code-inner js-file-line">a degree of convergence	mức độ hòa nhập</td>
        <td id="LC4" class="blob-code blob-code-inner js-file-line">a national training interviewing initiative	sáng kiến đào tạo phỏng vấn quốc gia</td>
        <td id="LC5" class="blob-code blob-code-inner js-file-line">aberrant sexual preference	khuynh hướng tình dục khác thường</td>
        <td id="LC6" class="blob-code blob-code-inner js-file-line">abiding conviction of guilt	giữ nguyên bản án</td>
        <td id="LC7" class="blob-code blob-code-inner js-file-line">absenteeism	vắng mặt không lý do</td>
        <td id="LC8" class="blob-code blob-code-inner js-file-line">abuser	kẻ lạm dụng</td>
        <td id="LC9" class="blob-code blob-code-inner js-file-line">accreditation criteria	tiêu chuẩn đáng tin cậy</td>
        <td id="LC10" class="blob-code blob-code-inner js-file-line">accuracy	tính chính xác</td>
        <td id="LC11" class="blob-code blob-code-inner js-file-line">Accusatory	có tính cách buộc tội, tố cáo</td>
        <td id="LC12" class="blob-code blob-code-inner js-file-line">achieve closure	đạt được thỏa thuận</td>
        <td id="LC13" class="blob-code blob-code-inner js-file-line">Acknowledgement	Sự công nhận</td>
        <td id="LC14" class="blob-code blob-code-inner js-file-line">actual and substantial doubt	nghi ngờ thực tế và đáng kể</td>
        <td id="LC15" class="blob-code blob-code-inner js-file-line">actuarial	thống kê tính toán bảo hiểm</td>
        <td id="LC16" class="blob-code blob-code-inner js-file-line">admissibility	tính chấp nhận được</td>
        <td id="LC17" class="blob-code blob-code-inner js-file-line">adversarial	đối địch</td>
        <td id="LC18" class="blob-code blob-code-inner js-file-line">advisory	tư vấn</td>
        <td id="LC19" class="blob-code blob-code-inner js-file-line">advocate	người ủng hộ</td>
        <td id="LC20" class="blob-code blob-code-inner js-file-line">Aggressive	xung hấn</td>
        <td id="LC21" class="blob-code blob-code-inner js-file-line">aggressor	yếu tố gây hấn/ yếu tố bất lợi</td>
        <td id="LC22" class="blob-code blob-code-inner js-file-line">aid	phụ trợ</td>
        <td id="LC23" class="blob-code blob-code-inner js-file-line">an independent committe of inquiry	ủy ban điều tra độc lập</td>
        <td id="LC24" class="blob-code blob-code-inner js-file-line">Analysis	phân tích</td>
        <td id="LC25" class="blob-code blob-code-inner js-file-line">anger excitation	sự kích thích do tức giận</td>
        <td id="LC26" class="blob-code blob-code-inner js-file-line">anger reataliation	sự trả đũa do tức giận</td>
        <td id="LC27" class="blob-code blob-code-inner js-file-line">anus	hậu môn</td>
        <td id="LC28" class="blob-code blob-code-inner js-file-line">apprehend	nhận biết</td>
        <td id="LC29" class="blob-code blob-code-inner js-file-line">apprehension	sự lĩnh hội, am hiểu</td>
        <td id="LC30" class="blob-code blob-code-inner js-file-line">Approach	tiếp cận</td>
        <td id="LC31" class="blob-code blob-code-inner js-file-line">arousal	kích thích</td>
        <td id="LC32" class="blob-code blob-code-inner js-file-line">array of duties	phân phối trách nhiệm</td>
        <td id="LC33" class="blob-code blob-code-inner js-file-line">arson	phóng hỏa</td>
        <td id="LC34" class="blob-code blob-code-inner js-file-line">aspect	khía cạnh</td>
        <td id="LC35" class="blob-code blob-code-inner js-file-line">assertive	quyết đoán</td>
        <td id="LC36" class="blob-code blob-code-inner js-file-line">assess	đánh giá</td>
        <td id="LC37" class="blob-code blob-code-inner js-file-line">assumption	giả định</td>
        <td id="LC38" class="blob-code blob-code-inner js-file-line">Attorney General’s Guidelines	Hướng dẫn chung cho luật sư</td>
        <td id="LC39" class="blob-code blob-code-inner js-file-line">Australian Bureau of Statistics	Cục Thống kê Úc</td>
        <td id="LC40" class="blob-code blob-code-inner js-file-line">authoritarianism	(sự) độc đoán</td>
        <td id="LC41" class="blob-code blob-code-inner js-file-line">Autonomous	tự trị</td>
        <td id="LC42" class="blob-code blob-code-inner js-file-line">aversion therapy	liệu pháp ác cảm</td>
        <td id="LC43" class="blob-code blob-code-inner js-file-line">bear in mind	ghi nhớ</td>
        <td id="LC44" class="blob-code blob-code-inner js-file-line">Behavioural cues	Các dấu hiệu hành vi</td>
        <td id="LC45" class="blob-code blob-code-inner js-file-line">behavioural indicators	những chỉ điểm tố giác về hành vi</td>
        <td id="LC46" class="blob-code blob-code-inner js-file-line">betting shop	văn phòng của người đánh cá ngựa</td>
        <td id="LC47" class="blob-code blob-code-inner js-file-line">bigamist	người vi phạm chế độ một vợ, một chồng.</td>
        <td id="LC48" class="blob-code blob-code-inner js-file-line">bobby on the beat	cảnh sát tuần tra</td>
        <td id="LC49" class="blob-code blob-code-inner js-file-line">British Academy of Forensic Sciences	viện hàn lâm Anh về khoa học điều tra</td>
        <td id="LC50" class="blob-code blob-code-inner js-file-line">brutal murder	giết người tàn bạo</td>
        <td id="LC51" class="blob-code blob-code-inner js-file-line">buffer zone	vùng đệm</td>
        <td id="LC52" class="blob-code blob-code-inner js-file-line">burglar	kẻ trộm đêm</td>
        <td id="LC53" class="blob-code blob-code-inner js-file-line">campaign	chiến dịch</td>
        <td id="LC54" class="blob-code blob-code-inner js-file-line">canteen culture	văn hóa căn-tin</td>
        <td id="LC55" class="blob-code blob-code-inner js-file-line">Capital punishment	án tử hình</td>
        <td id="LC56" class="blob-code blob-code-inner js-file-line">case linkage	kết nối vụ án</td>
        <td id="LC57" class="blob-code blob-code-inner js-file-line">Chief Inspector of Prisons	Chánh thanh tra</td>
        <td id="LC58" class="blob-code blob-code-inner js-file-line">child grooming	là hành động thiết lập mối quan hệ thân mật với một đứa trẻ nhằm dụ dỗ, lợi dụng nó</td>
        <td id="LC59" class="blob-code blob-code-inner js-file-line">child molester	kẻ xâm hại trẻ em</td>
        <td id="LC60" class="blob-code blob-code-inner js-file-line">Church law	luật của Nhà Thờ</td>
        <td id="LC61" class="blob-code blob-code-inner js-file-line">CID (Criminal Investigation Department)	Cục điều tra tội phạm (Cục điều tra hình sự)</td>
        <td id="LC62" class="blob-code blob-code-inner js-file-line">Circle Theory of Environmental Range	lý thuyết vòng tròn về phạm vi môi trường sống</td>
        <td id="LC63" class="blob-code blob-code-inner js-file-line">client	thân chủ/khách hàng</td>
        <td id="LC64" class="blob-code blob-code-inner js-file-line">clinical	lâm sàng</td>
        <td id="LC65" class="blob-code blob-code-inner js-file-line">clinical anxiety	lo âu lâm sàng</td>
        <td id="LC66" class="blob-code blob-code-inner js-file-line">Clinical profiling	Lập hồ sơ theo phương pháp lâm sàng</td>
        <td id="LC67" class="blob-code blob-code-inner js-file-line">coerced-compliant	cưỡng chế tuân thủ</td>
        <td id="LC68" class="blob-code blob-code-inner js-file-line">coerced-internalized	ép buộc từ bên trong</td>
        <td id="LC69" class="blob-code blob-code-inner js-file-line">coercion	sự ép buộc</td>
        <td id="LC70" class="blob-code blob-code-inner js-file-line">cognitive behavioural principle	liệu pháp nhận thức hành vi</td>
        <td id="LC71" class="blob-code blob-code-inner js-file-line">cognitive distortion	sự lệch lạc về nhận thức</td>
        <td id="LC72" class="blob-code blob-code-inner js-file-line">cognitive interview	phỏng vấn về nhận thức</td>
        <td id="LC73" class="blob-code blob-code-inner js-file-line">cognitive operations	hợp tác về nhận thức</td>
        <td id="LC74" class="blob-code blob-code-inner js-file-line">collaborare	hợp tác</td>
        <td id="LC75" class="blob-code blob-code-inner js-file-line">commendable striving	phấn đấu đáng khen ngợi</td>
        <td id="LC76" class="blob-code blob-code-inner js-file-line">commercial robber	kẻ cướp thương mại</td>
        <td id="LC77" class="blob-code blob-code-inner js-file-line">commit	phạm tội</td>
        <td id="LC78" class="blob-code blob-code-inner js-file-line">common sense	thường thức</td>
        <td id="LC79" class="blob-code blob-code-inner js-file-line">Community-base sentence	hình phạt dựa trên cộng đồng</td>
        <td id="LC80" class="blob-code blob-code-inner js-file-line">Commuter	người di chuyển hàng ngày</td>
        <td id="LC81" class="blob-code blob-code-inner js-file-line">complex statistical	thống kê phức tạp</td>
        <td id="LC82" class="blob-code blob-code-inner js-file-line">composition	sự cấu thành</td>
        <td id="LC83" class="blob-code blob-code-inner js-file-line">Conceptualize	Quan niệm hóa, nhận thức hóa</td>
        <td id="LC84" class="blob-code blob-code-inner js-file-line">confession-driven model	mô hình thúc đẩy sự thú nhận</td>
        <td id="LC85" class="blob-code blob-code-inner js-file-line">conjecture or fanciful doubt	mối nghi ngờ phỏng đoán hoặc không có thật</td>
        <td id="LC86" class="blob-code blob-code-inner js-file-line">consensus	sự đồng thuận/nhất trí</td>
        <td id="LC87" class="blob-code blob-code-inner js-file-line">consent	đồng thuận</td>
        <td id="LC88" class="blob-code blob-code-inner js-file-line">conservatism	(sự) bảo thủ</td>
        <td id="LC89" class="blob-code blob-code-inner js-file-line">constitutes routine police activities	các hoạt động thường lệ của cảnh sát</td>
        <td id="LC90" class="blob-code blob-code-inner js-file-line">contemporary	đương thời</td>
        <td id="LC91" class="blob-code blob-code-inner js-file-line">Control Question Test	Bài kiểm tra khả năng kiểm soát</td>
        <td id="LC92" class="blob-code blob-code-inner js-file-line">conviction	sự kết án</td>
        <td id="LC93" class="blob-code blob-code-inner js-file-line">coping mechanism	cơ chế sao chép</td>
        <td id="LC94" class="blob-code blob-code-inner js-file-line">Corporal	về thể xác</td>
        <td id="LC95" class="blob-code blob-code-inner js-file-line">Correctional Service of Canada	Cơ quan Cải huấn Canada</td>
        <td id="LC96" class="blob-code blob-code-inner js-file-line">cost-benefit analysis	phân tích chi phí-lợi ích</td>
        <td id="LC97" class="blob-code blob-code-inner js-file-line">Court of Appeal	Tòa phúc thẩm</td>
        <td id="LC98" class="blob-code blob-code-inner js-file-line">courtroom language	ngôn ngữ phòng xử án</td>
        <td id="LC99" class="blob-code blob-code-inner js-file-line">courtroom linguists	ngôn ngữ phòng xử án</td>
        <td id="LC100" class="blob-code blob-code-inner js-file-line">covert sensitization	gán 1 thói hư tật xấu nào đó với 1 hình ảnh tiêu cực để triệt thoái thói hư đó</td>
        <td id="LC101" class="blob-code blob-code-inner js-file-line">Crime Reduction Programme	Chương Trình Giảm Thiểu Tội Ác</td>
        <td id="LC102" class="blob-code blob-code-inner js-file-line">Criminal Justice Act	đạo luật hình sự</td>
        <td id="LC103" class="blob-code blob-code-inner js-file-line">criminal justice system	hệ thống tư pháp hình sự</td>
        <td id="LC104" class="blob-code blob-code-inner js-file-line">Criminal profiling	thiết lập hồ sơ tội phạm</td>
        <td id="LC105" class="blob-code blob-code-inner js-file-line">Criminal psychologist	Nhà tâm lý học tội phạm</td>
        <td id="LC106" class="blob-code blob-code-inner js-file-line">Criminal range	phạm vi phạm tội</td>
        <td id="LC107" class="blob-code blob-code-inner js-file-line">criminal setting	hệ thống sắp đặt tội phạm</td>
        <td id="LC108" class="blob-code blob-code-inner js-file-line">Criminogenic factor	Tội phạm tiềm ẩn</td>
        <td id="LC109" class="blob-code blob-code-inner js-file-line">Criminogenic needs	Các nhu cầu dẫn đến phạm tội</td>
        <td id="LC110" class="blob-code blob-code-inner js-file-line">Criteria-based	căn cứ theo tiêu chí</td>
        <td id="LC111" class="blob-code blob-code-inner js-file-line">criterion	tiêu chuẩn</td>
        <td id="LC112" class="blob-code blob-code-inner js-file-line">criticize	chỉ trích</td>
        <td id="LC113" class="blob-code blob-code-inner js-file-line">cross-examination	đối thẩm</td>
        <td id="LC114" class="blob-code blob-code-inner js-file-line">cross-examine	Sự thẩm vấn/ buổi thẩm vấn</td>
        <td id="LC115" class="blob-code blob-code-inner js-file-line">cross-racial identification	dạng nhận dạng khác màu da</td>
        <td id="LC116" class="blob-code blob-code-inner js-file-line">cross-situational consistency	sự kiên định/ chắc chắn trong mọi tình huống</td>
        <td id="LC117" class="blob-code blob-code-inner js-file-line">defendant	bị cáo</td>
        <td id="LC118" class="blob-code blob-code-inner js-file-line">demographic characteristics	đặc điểm nhân khẩu học</td>
        <td id="LC119" class="blob-code blob-code-inner js-file-line">Describing	mô tả</td>
        <td id="LC120" class="blob-code blob-code-inner js-file-line">Detecting deception	Phát hiện sự lừa dối</td>
        <td id="LC121" class="blob-code blob-code-inner js-file-line">detection of deception	Sự phát hiện lừa dối</td>
        <td id="LC122" class="blob-code blob-code-inner js-file-line">deterioation	(sự) sa đọa</td>
        <td id="LC123" class="blob-code blob-code-inner js-file-line">deterrence	sự ngăn cản</td>
        <td id="LC124" class="blob-code blob-code-inner js-file-line">Deviant	người có hành vi sai lệch so với những quy chuẩn</td>
        <td id="LC125" class="blob-code blob-code-inner js-file-line">dilemma	tiến thoái lưỡng nan, tình trạng khó xử</td>
        <td id="LC126" class="blob-code blob-code-inner js-file-line">discomfort	lo lắng, bực dọc</td>
        <td id="LC127" class="blob-code blob-code-inner js-file-line">Discriminated	phân biệt đối xử</td>
        <td id="LC128" class="blob-code blob-code-inner js-file-line">distance decay	phân rã khoảng cách</td>
        <td id="LC129" class="blob-code blob-code-inner js-file-line">distinctions	phân biệt</td>
        <td id="LC130" class="blob-code blob-code-inner js-file-line">Distorted attitudes	thái độ lệch lạc</td>
        <td id="LC131" class="blob-code blob-code-inner js-file-line">distractor	yếu tố gây xao nhãng</td>
        <td id="LC132" class="blob-code blob-code-inner js-file-line">distress	nỗi buồn</td>
        <td id="LC133" class="blob-code blob-code-inner js-file-line">dogmatism	(sự) giáo điều</td>
        <td id="LC134" class="blob-code blob-code-inner js-file-line">domestic violence	bạo lực gia đình</td>
        <td id="LC135" class="blob-code blob-code-inner js-file-line">dominant language	ngôn ngữ chính</td>
        <td id="LC136" class="blob-code blob-code-inner js-file-line">duplication	bản sao</td>
        <td id="LC137" class="blob-code blob-code-inner js-file-line">earwitness testimony	chứng thực của nhân chứng nghe thấy mọi việc (chỉ tội ác)</td>
        <td id="LC138" class="blob-code blob-code-inner js-file-line">Eclectic	người chiết trung (người trung gian chuyển ý tuởng, suy nghĩ, nhận xét từ nhiều nguồn rộng và đa dạng xuống)</td>
        <td id="LC139" class="blob-code blob-code-inner js-file-line">ecologically	môi trường / sinh thái</td>
        <td id="LC140" class="blob-code blob-code-inner js-file-line">economic deprivation	(sự) tước đoạt về hoạt động kinh tế/mất kế sinh nhai</td>
        <td id="LC141" class="blob-code blob-code-inner js-file-line">empathy	sự thấu cảm</td>
        <td id="LC142" class="blob-code blob-code-inner js-file-line">empirical	kinh nghiệm</td>
        <td id="LC143" class="blob-code blob-code-inner js-file-line">empirical evidence	thông tin được chứng thực từ sự quan sát/ trải nghiệm</td>
        <td id="LC144" class="blob-code blob-code-inner js-file-line">encompass	chứa đựng</td>
        <td id="LC145" class="blob-code blob-code-inner js-file-line">encounter	sự chạm trán</td>
        <td id="LC146" class="blob-code blob-code-inner js-file-line">Endorsed	tán thành</td>
        <td id="LC147" class="blob-code blob-code-inner js-file-line">enforced removal	tước bỏ bắt buộc</td>
        <td id="LC148" class="blob-code blob-code-inner js-file-line">engage in	tiến hành</td>
        <td id="LC149" class="blob-code blob-code-inner js-file-line">Environmental criminology	môn tội phạm học về môi trường</td>
        <td id="LC150" class="blob-code blob-code-inner js-file-line">error-prone	dễ bị lỗi</td>
        <td id="LC151" class="blob-code blob-code-inner js-file-line">ethical psychological notion	khái niệm tâm lý đạo đức</td>
        <td id="LC152" class="blob-code blob-code-inner js-file-line">ethically and morally questionable procedures	thủ tục có vấn đề về đạo đức và luân lý</td>
        <td id="LC153" class="blob-code blob-code-inner js-file-line">ethnicity	dân tộc/ chủng tộc</td>
        <td id="LC154" class="blob-code blob-code-inner js-file-line">evidence of linguistic competence	chứng cứ về năng lực ngôn ngữ</td>
        <td id="LC155" class="blob-code blob-code-inner js-file-line">evidence of meaning	bằng chứng của ý nghĩa</td>
        <td id="LC156" class="blob-code blob-code-inner js-file-line">evidence-based practice	hoạt động/ chữa trị dựa trên các bằng chứng khoa học</td>
        <td id="LC157" class="blob-code blob-code-inner js-file-line">examinations-in-chief	người kiểm tra chính</td>
        <td id="LC158" class="blob-code blob-code-inner js-file-line">exhaustive	thấu đáo</td>
        <td id="LC159" class="blob-code blob-code-inner js-file-line">experimental	thực nghiệm</td>
        <td id="LC160" class="blob-code blob-code-inner js-file-line">eyewitness research	nghiên cứu về nhân chứng</td>
        <td id="LC161" class="blob-code blob-code-inner js-file-line">eyewitness testimony	lời khai của nhân chứng</td>
        <td id="LC162" class="blob-code blob-code-inner js-file-line">false confession	lời thú nhận giả / khai man</td>
        <td id="LC163" class="blob-code blob-code-inner js-file-line">FBI	cục điều tra liên bang</td>
        <td id="LC164" class="blob-code blob-code-inner js-file-line">Federal	liên bang</td>
        <td id="LC165" class="blob-code blob-code-inner js-file-line">fellow prisoner	bạn tù</td>
        <td id="LC166" class="blob-code blob-code-inner js-file-line">feminist researchers	các nhà nghiên cứu về nữ quyền</td>
        <td id="LC167" class="blob-code blob-code-inner js-file-line">financial reward	phần thưởng tài chính</td>
        <td id="LC168" class="blob-code blob-code-inner js-file-line">fledging discipline	ngành nghiên cứu non trẻ</td>
        <td id="LC169" class="blob-code blob-code-inner js-file-line">foil	giấy nhôm, giấy bạc/ làm nền</td>
        <td id="LC170" class="blob-code blob-code-inner js-file-line">forensic linguistics	ngôn ngữ học pháp lý</td>
        <td id="LC171" class="blob-code blob-code-inner js-file-line">forensic psychologist	nhà tâm lý học pháp y / điều tra</td>
        <td id="LC172" class="blob-code blob-code-inner js-file-line">forensic psychology	tâm lý học pháp y</td>
        <td id="LC173" class="blob-code blob-code-inner js-file-line">frailties	những điểm yếu</td>
        <td id="LC174" class="blob-code blob-code-inner js-file-line">futility of denial	phủ nhận vô ích</td>
        <td id="LC175" class="blob-code blob-code-inner js-file-line">gauge	đánh giá, phán đoán</td>
        <td id="LC176" class="blob-code blob-code-inner js-file-line">Gay Police Association	Hiệp hội Cảnh sát Đồng tính</td>
        <td id="LC177" class="blob-code blob-code-inner js-file-line">genenarl attorney	văn phòng luật sư công</td>
        <td id="LC178" class="blob-code blob-code-inner js-file-line">General Health Questionnaire	Bảng câu hỏi sức khỏe tổng quát</td>
        <td id="LC179" class="blob-code blob-code-inner js-file-line">Geographical profiling	Lập hồ sơ tội phạm dựa theo yếu tố địa lý</td>
        <td id="LC180" class="blob-code blob-code-inner js-file-line">glean	lượm lặt</td>
        <td id="LC181" class="blob-code blob-code-inner js-file-line">grammatical structure	cấu trúc ngữ pháp</td>
        <td id="LC182" class="blob-code blob-code-inner js-file-line">grievance procedure	thủ tục giải quyết khiếu nại</td>
        <td id="LC183" class="blob-code blob-code-inner js-file-line">grooming	chải chuốt / chuẩn bị</td>
        <td id="LC184" class="blob-code blob-code-inner js-file-line">ground truth	thực địa</td>
        <td id="LC185" class="blob-code blob-code-inner js-file-line">Guillotine	Máy chém</td>
        <td id="LC186" class="blob-code blob-code-inner js-file-line">Guilty Knowledge Test	Bài kiểm tra sự nhận biết các hành vi phạm tội</td>
        <td id="LC187" class="blob-code blob-code-inner js-file-line">have-a-go-hero	người ngăn cản các hành vi phạm tội mặc cho an nguy của mình</td>
        <td id="LC188" class="blob-code blob-code-inner js-file-line">heterosexual relationship	Quan hệ khác giới</td>
        <td id="LC189" class="blob-code blob-code-inner js-file-line">hierarchy	hệ thống cấp bậc</td>
        <td id="LC190" class="blob-code blob-code-inner js-file-line">high stake	độ nguy hiểm cao</td>
        <td id="LC191" class="blob-code blob-code-inner js-file-line">historic language	ngôn ngữ lịch sử</td>
        <td id="LC192" class="blob-code blob-code-inner js-file-line">home range	phạm vi cư trú</td>
        <td id="LC193" class="blob-code blob-code-inner js-file-line">homology assumption	giả định tương đồng</td>
        <td id="LC194" class="blob-code blob-code-inner js-file-line">homophobic	sợ/ kỳ thị đồng tính</td>
        <td id="LC195" class="blob-code blob-code-inner js-file-line">horrendous	khủng khiếp</td>
        <td id="LC196" class="blob-code blob-code-inner js-file-line">hunter	kẻ đi săn</td>
        <td id="LC197" class="blob-code blob-code-inner js-file-line">hypnosis	sự thôi miên</td>
        <td id="LC198" class="blob-code blob-code-inner js-file-line">identification parade/line-up	hàng người được đưa ra để nhân chứng nhận diện</td>
        <td id="LC199" class="blob-code blob-code-inner js-file-line">idiosyncratic	đặc tính / phong cách riêng/ đặc thù (nghĩa xấu)</td>
        <td id="LC200" class="blob-code blob-code-inner js-file-line">illegal activity	hoạt động phi pháp</td>
        <td id="LC201" class="blob-code blob-code-inner js-file-line">imaginary doubt	nghi ngờ tưởng tượng</td>
        <td id="LC202" class="blob-code blob-code-inner js-file-line">impetus	sự thúc đẩy</td>
        <td id="LC203" class="blob-code blob-code-inner js-file-line">imprisonment	(sự) giam giữ</td>
        <td id="LC204" class="blob-code blob-code-inner js-file-line">impulsive	hấp tấp</td>
        <td id="LC205" class="blob-code blob-code-inner js-file-line">impulsivity	sự bốc đồng</td>
        <td id="LC206" class="blob-code blob-code-inner js-file-line">in jail	ở nhà tạm giam</td>
        <td id="LC207" class="blob-code blob-code-inner js-file-line">in line with	ngang hàng / đồng hành</td>
        <td id="LC208" class="blob-code blob-code-inner js-file-line">in prison	ở tù</td>
        <td id="LC209" class="blob-code blob-code-inner js-file-line">incarceration	(sự) tống giam</td>
        <td id="LC210" class="blob-code blob-code-inner js-file-line">index offence	chỉ số hành vi phạm tội</td>
        <td id="LC211" class="blob-code blob-code-inner js-file-line">Indicate	biểu thị</td>
        <td id="LC212" class="blob-code blob-code-inner js-file-line">Individuals	các cá nhân</td>
        <td id="LC213" class="blob-code blob-code-inner js-file-line">inferring/ inference	sự suy luận/ suy luận</td>
        <td id="LC214" class="blob-code blob-code-inner js-file-line">inform	cung cấp tài liệu, tin tức (để buộc tội ai)</td>
        <td id="LC215" class="blob-code blob-code-inner js-file-line">informant	người cung cấp tin tức</td>
        <td id="LC216" class="blob-code blob-code-inner js-file-line">inhibition	ngăn chặn / ức chế</td>
        <td id="LC217" class="blob-code blob-code-inner js-file-line">inmate code	mã số tù nhân</td>
        <td id="LC218" class="blob-code blob-code-inner js-file-line">innocence project	dự án vô tội</td>
        <td id="LC219" class="blob-code blob-code-inner js-file-line">institutional racism	sự phân biệt chủng tộc có tính chất cơ quan</td>
        <td id="LC220" class="blob-code blob-code-inner js-file-line">integrity	sự chính trực</td>
        <td id="LC221" class="blob-code blob-code-inner js-file-line">internal bodily activities	hoạt động bên trong cơ thể</td>
        <td id="LC222" class="blob-code blob-code-inner js-file-line">International Centre for Prison Studies	Trung tâm Nghiên cứu Nhà tù Quốc tế</td>
        <td id="LC223" class="blob-code blob-code-inner js-file-line">interrogators	người thẩm vấn</td>
        <td id="LC224" class="blob-code blob-code-inner js-file-line">intuition	trực giác</td>
        <td id="LC225" class="blob-code blob-code-inner js-file-line">judicial proceeding	tố tụng pháp lý</td>
        <td id="LC226" class="blob-code blob-code-inner js-file-line">judicial system	hệ thống tư pháp</td>
        <td id="LC227" class="blob-code blob-code-inner js-file-line">juror	thành viên bồi thẩm đoàn</td>
        <td id="LC228" class="blob-code blob-code-inner js-file-line">justification	bào chữa, biện hộ</td>
        <td id="LC229" class="blob-code blob-code-inner js-file-line">juvenile detention centre	Trung tâm giam giữ vị thành niên</td>
        <td id="LC230" class="blob-code blob-code-inner js-file-line">known offences	những vụ phạm tội đã biết</td>
        <td id="LC231" class="blob-code blob-code-inner js-file-line">language of the law	ngôn ngữ của pháp luật</td>
        <td id="LC232" class="blob-code blob-code-inner js-file-line">law-abiding citizen	công dân tuân thủ pháp luật</td>
        <td id="LC233" class="blob-code blob-code-inner js-file-line">legal	hợp pháp</td>
        <td id="LC234" class="blob-code blob-code-inner js-file-line">legal context	bối cảnh pháp lý</td>
        <td id="LC235" class="blob-code blob-code-inner js-file-line">legal examination	kiểm tra pháp lý</td>
        <td id="LC236" class="blob-code blob-code-inner js-file-line">legal language	ngôn ngữ pháp lý</td>
        <td id="LC237" class="blob-code blob-code-inner js-file-line">legal profession	nghề luật</td>
        <td id="LC238" class="blob-code blob-code-inner js-file-line">legal representation	đại diện hợp pháp</td>
        <td id="LC239" class="blob-code blob-code-inner js-file-line">legal system	hệ thống pháp luật</td>
        <td id="LC240" class="blob-code blob-code-inner js-file-line">legal texts	văn bản quy phạm pháp luật</td>
        <td id="LC241" class="blob-code blob-code-inner js-file-line">lethal violence	bạo lực gây chết người</td>
        <td id="LC242" class="blob-code blob-code-inner js-file-line">lexical diversity	sự đa dạng về từ vựng</td>
        <td id="LC243" class="blob-code blob-code-inner js-file-line">life sentence	tù chung thân</td>
        <td id="LC244" class="blob-code blob-code-inner js-file-line">likelihood	khả năng</td>
        <td id="LC245" class="blob-code blob-code-inner js-file-line">linguistic	ngôn ngữ học</td>
        <td id="LC246" class="blob-code blob-code-inner js-file-line">linguistic analysis	phân tích ngôn ngữ</td>
        <td id="LC247" class="blob-code blob-code-inner js-file-line">linguistic competence	năng lực ngôn ngữ</td>
        <td id="LC248" class="blob-code blob-code-inner js-file-line">linguistically vulnerable	có vấn đề về ngôn ngữ</td>
        <td id="LC249" class="blob-code blob-code-inner js-file-line">long sentence	án tù lâu lăm</td>
        <td id="LC250" class="blob-code blob-code-inner js-file-line">longer response latency	sự ngầm hưởng ứng lâu dài</td>
        <td id="LC251" class="blob-code blob-code-inner js-file-line">Lynch mob	đám đông xét xử</td>
        <td id="LC252" class="blob-code blob-code-inner js-file-line">Lynching	Lối hành hình không cần xét xử</td>
        <td id="LC253" class="blob-code blob-code-inner js-file-line">maladaptive strategy	chiến lược không thích nghi</td>
        <td id="LC254" class="blob-code blob-code-inner js-file-line">mandated	được cho phép</td>
        <td id="LC255" class="blob-code blob-code-inner js-file-line">manipulate	kiểm soát</td>
        <td id="LC256" class="blob-code blob-code-inner js-file-line">Marauder	kẻ cướp</td>
        <td id="LC257" class="blob-code blob-code-inner js-file-line">martial court	tòa án binh</td>
        <td id="LC258" class="blob-code blob-code-inner js-file-line">mediate	dàn xếp</td>
        <td id="LC259" class="blob-code blob-code-inner js-file-line">mental map	bản đồ trí nhớ</td>
        <td id="LC260" class="blob-code blob-code-inner js-file-line">mere possible doubt	chỉ có thể nghi ngờ</td>
        <td id="LC261" class="blob-code blob-code-inner js-file-line">Meta-analysis	Phân tích tổng hợp</td>
        <td id="LC262" class="blob-code blob-code-inner js-file-line">meticulously	tiỉ mỉ, quá kĩ càng</td>
        <td id="LC263" class="blob-code blob-code-inner js-file-line">Miranda rights	Quyền Miranda</td>
        <td id="LC264" class="blob-code blob-code-inner js-file-line">miscarriage of justice	vụ án xử oan</td>
        <td id="LC265" class="blob-code blob-code-inner js-file-line">monologue	độc thoại</td>
        <td id="LC266" class="blob-code blob-code-inner js-file-line">moral reasoning training	Huấn luyện về lâp luận đạo đức</td>
        <td id="LC267" class="blob-code blob-code-inner js-file-line">murder	vụ án mạng, tội giết người</td>
        <td id="LC268" class="blob-code blob-code-inner js-file-line">mutilation	 &quot;chết không toàn thây&quot;, bị phân thây hay bị phá hủy nặng nề</td>
        <td id="LC269" class="blob-code blob-code-inner js-file-line">nausea-inducing drug	thuốc gây ra các cảm giác ói mửa (thường dùng trong liệu pháp ác cảm )</td>
        <td id="LC270" class="blob-code blob-code-inner js-file-line">Neighbourhood Warden Schemes	Các kế hoạch về hoạt động dân phòng</td>
        <td id="LC271" class="blob-code blob-code-inner js-file-line">non-consensual sexual act	hành vi tình dục không được đồng thuận</td>
        <td id="LC272" class="blob-code blob-code-inner js-file-line">non-custodial study	nghiên cứu không trực tiếp trong tù</td>
        <td id="LC273" class="blob-code blob-code-inner js-file-line">notion	ý niệm, quan niệm</td>
        <td id="LC274" class="blob-code blob-code-inner js-file-line">notoriety	trạng thái rõ ràng</td>
        <td id="LC275" class="blob-code blob-code-inner js-file-line">offence	tội ác</td>
        <td id="LC276" class="blob-code blob-code-inner js-file-line">offence-specific	tội ác đặc thù</td>
        <td id="LC277" class="blob-code blob-code-inner js-file-line">offender	người phạm tội</td>
        <td id="LC278" class="blob-code blob-code-inner js-file-line">offender consistency hypothesis	giả thuyết về tính nhất quán của hành vi phạm tội</td>
        <td id="LC279" class="blob-code blob-code-inner js-file-line">offender profilers	người lập hồ sơ tội phạm</td>
        <td id="LC280" class="blob-code blob-code-inner js-file-line">offender profiling	lập hồ sơ tội phạm</td>
        <td id="LC281" class="blob-code blob-code-inner js-file-line">on release	phóng thích</td>
        <td id="LC282" class="blob-code blob-code-inner js-file-line">oppressive	áp chế</td>
        <td id="LC283" class="blob-code blob-code-inner js-file-line">ostracism	tẩy chay, trục xuất</td>
        <td id="LC284" class="blob-code blob-code-inner js-file-line">overlap	chồng chéo</td>
        <td id="LC285" class="blob-code blob-code-inner js-file-line">paedolphile	người có khoái cảm tình dục với trẻ con</td>
        <td id="LC286" class="blob-code blob-code-inner js-file-line">palmar sweating	sự đổ mồ hôi gan bàn tay</td>
        <td id="LC287" class="blob-code blob-code-inner js-file-line">parameter	thông số</td>
        <td id="LC288" class="blob-code blob-code-inner js-file-line">Participants observe	những người tham gia quan sát</td>
        <td id="LC289" class="blob-code blob-code-inner js-file-line">particular type	hình mẫu cụ thể</td>
        <td id="LC290" class="blob-code blob-code-inner js-file-line">pattent letters	giấy chấp thuận, đặc ân từ hoàng gia, tổng thống</td>
        <td id="LC291" class="blob-code blob-code-inner js-file-line">Pattern Theory	Lý thuyết Kiểu mẫu</td>
        <td id="LC292" class="blob-code blob-code-inner js-file-line">penetration	xâm nhập</td>
        <td id="LC293" class="blob-code blob-code-inner js-file-line">penis	dương vật</td>
        <td id="LC294" class="blob-code blob-code-inner js-file-line">perceived distance	khoảng cách cảm nhận</td>
        <td id="LC295" class="blob-code blob-code-inner js-file-line">perception	nhận thức</td>
        <td id="LC296" class="blob-code blob-code-inner js-file-line">perpetrator	thủ phạm</td>
        <td id="LC297" class="blob-code blob-code-inner js-file-line">perspective	quan điểm</td>
        <td id="LC298" class="blob-code blob-code-inner js-file-line">persuasive/manipulative tactics	chiến thuật thuyết phục/ lôi kéo</td>
        <td id="LC299" class="blob-code blob-code-inner js-file-line">pioneering	tiên phong</td>
        <td id="LC300" class="blob-code blob-code-inner js-file-line">poacher	kẻ săn trộm</td>
        <td id="LC301" class="blob-code blob-code-inner js-file-line">Police and Criminal Envidence Act	Đạo luật về Cảnh sát và Bằng chứng Phạm tội</td>
        <td id="LC302" class="blob-code blob-code-inner js-file-line">Police civilian staff	nhân viên cảnh sát dân sự</td>
        <td id="LC303" class="blob-code blob-code-inner js-file-line">Police Community Support Officers	Những đồng chí trong cộng đồng ủng hộ cảnh sát</td>
        <td id="LC304" class="blob-code blob-code-inner js-file-line">police service representative	đại diện dịch vụ cảnh sát</td>
        <td id="LC305" class="blob-code blob-code-inner js-file-line">policy-maker	nhà hoạch định chính sách</td>
        <td id="LC306" class="blob-code blob-code-inner js-file-line">polypraph	máy phát hiện nói dối</td>
        <td id="LC307" class="blob-code blob-code-inner js-file-line">pool with sth	cùng với cái gì...</td>
        <td id="LC308" class="blob-code blob-code-inner js-file-line">portray	mô tả</td>
        <td id="LC309" class="blob-code blob-code-inner js-file-line">possible doubt	có thể nghi ngờ</td>
        <td id="LC310" class="blob-code blob-code-inner js-file-line">post-mortem reports	báo cáo khám nghiệm tử thi</td>
        <td id="LC311" class="blob-code blob-code-inner js-file-line">Post-traumatic Stress Disorder (PTSD)	Rối loạn stress sau sang chấn</td>
        <td id="LC312" class="blob-code blob-code-inner js-file-line">power assertive	khẳng định quyền lực</td>
        <td id="LC313" class="blob-code blob-code-inner js-file-line">power excitation	hứng thú với quyền lực</td>
        <td id="LC314" class="blob-code blob-code-inner js-file-line">power reassurance	đảm bảo quyền lực</td>
        <td id="LC315" class="blob-code blob-code-inner js-file-line">practicality	tính thực tế</td>
        <td id="LC316" class="blob-code blob-code-inner js-file-line">preconviction	tiền kết tội</td>
        <td id="LC317" class="blob-code blob-code-inner js-file-line">predominantly	chủ yếu</td>
        <td id="LC318" class="blob-code blob-code-inner js-file-line">Premeditation	hành động chủ tâm</td>
        <td id="LC319" class="blob-code blob-code-inner js-file-line">preoccupation	sự ám ảnh</td>
        <td id="LC320" class="blob-code blob-code-inner js-file-line">prioritize	ưu tiên</td>
        <td id="LC321" class="blob-code blob-code-inner js-file-line">Prison and Probation Service	Cơ quan quản lý nhà tù và giám sát phạm nhân</td>
        <td id="LC322" class="blob-code blob-code-inner js-file-line">Private Security Industry Act	Đạo luật về Lĩnh vực An ninh Tư nhân</td>
        <td id="LC323" class="blob-code blob-code-inner js-file-line">probalistic	xác suất</td>
        <td id="LC324" class="blob-code blob-code-inner js-file-line">probation area	khu vực quản chế</td>
        <td id="LC325" class="blob-code blob-code-inner js-file-line">probation services	institutions that treat young offenders</td>
        <td id="LC326" class="blob-code blob-code-inner js-file-line">prominence	nổi bật</td>
        <td id="LC327" class="blob-code blob-code-inner js-file-line">prosecution	bên khởi tố</td>
        <td id="LC328" class="blob-code blob-code-inner js-file-line">prosecution	việc khởi tố</td>
        <td id="LC329" class="blob-code blob-code-inner js-file-line">psychological disturbance	rối loạn tâm lý</td>
        <td id="LC330" class="blob-code blob-code-inner js-file-line">psychological intervention	can thiệp tâm lý</td>
        <td id="LC331" class="blob-code blob-code-inner js-file-line">psychologically	tâm lý</td>
        <td id="LC332" class="blob-code blob-code-inner js-file-line">psychometric test	bài kiểm tra tâm lý</td>
        <td id="LC333" class="blob-code blob-code-inner js-file-line">psychometric tests	các bài kiểm tra tâm lý (thuật ngữ thường dùng trong tuyển dụng các ngành đòi hỏi tính chất nhân cách đặc thù)</td>
        <td id="LC334" class="blob-code blob-code-inner js-file-line">publication	xuất bản</td>
        <td id="LC335" class="blob-code blob-code-inner js-file-line">punishment	hình phạt</td>
        <td id="LC336" class="blob-code blob-code-inner js-file-line">questionnaire-based measures	phương pháp bảng câu hỏi</td>
        <td id="LC337" class="blob-code blob-code-inner js-file-line">Randomized Control Trial (RCT)	(phương pháp) Đối chứng ngẫu nhiên</td>
        <td id="LC338" class="blob-code blob-code-inner js-file-line">Range of attention narrows	phạm vi hẹp của sự chú ý</td>
        <td id="LC339" class="blob-code blob-code-inner js-file-line">rape	cưỡng hiếp</td>
        <td id="LC340" class="blob-code blob-code-inner js-file-line">rape trial	xét xử hiếp dâm</td>
        <td id="LC341" class="blob-code blob-code-inner js-file-line">rapist	người phạm tội hãm hiếp</td>
        <td id="LC342" class="blob-code blob-code-inner js-file-line">rational choice	sự lựa chọn dựa trên lý trí</td>
        <td id="LC343" class="blob-code blob-code-inner js-file-line">Rationale	lý do căn bản</td>
        <td id="LC344" class="blob-code blob-code-inner js-file-line">re-victimization	tái nạn nhân</td>
        <td id="LC345" class="blob-code blob-code-inner js-file-line">reality monitoring	giám sát thực tế</td>
        <td id="LC346" class="blob-code blob-code-inner js-file-line">reasonable doubt	mối nghi ngờ hợp lý</td>
        <td id="LC347" class="blob-code blob-code-inner js-file-line">recidivism	(sự) tái phạm</td>
        <td id="LC348" class="blob-code blob-code-inner js-file-line">recollection	hồi ức</td>
        <td id="LC349" class="blob-code blob-code-inner js-file-line">Recommended Further Reading	Những bài viết nên đọc</td>
        <td id="LC350" class="blob-code blob-code-inner js-file-line">Reconviction	Tái kết án</td>
        <td id="LC351" class="blob-code blob-code-inner js-file-line">reductivism	tính thu hẹp lại</td>
        <td id="LC352" class="blob-code blob-code-inner js-file-line">rehabilitation	(sự) cải tạo</td>
        <td id="LC353" class="blob-code blob-code-inner js-file-line">relapse prevention	ngăn chặn tái phạm</td>
        <td id="LC354" class="blob-code blob-code-inner js-file-line">relevant	liên quan/ can hệ</td>
        <td id="LC355" class="blob-code blob-code-inner js-file-line">remand prisoner	phạm nhân vẫn đang được điều tra</td>
        <td id="LC356" class="blob-code blob-code-inner js-file-line">reoffending	(Sự) tái phạm</td>
        <td id="LC357" class="blob-code blob-code-inner js-file-line">retrieval	sự phục hồi</td>
        <td id="LC358" class="blob-code blob-code-inner js-file-line">Routine Activities Theory	Lý thuyết Các hoạt động Thường ngày</td>
        <td id="LC359" class="blob-code blob-code-inner js-file-line">Royal Commission On Crimminal Procedure	Ủy ban Hoàng gia về Quy trình Tố tụng Tội phạm</td>
        <td id="LC360" class="blob-code blob-code-inner js-file-line">sampling	lấy mẫu</td>
        <td id="LC361" class="blob-code blob-code-inner js-file-line">Savagery	tính tàn ác</td>
        <td id="LC362" class="blob-code blob-code-inner js-file-line">seek out	nhằm tìm kiếm</td>
        <td id="LC363" class="blob-code blob-code-inner js-file-line">self-esteem	tự trọng</td>
        <td id="LC364" class="blob-code blob-code-inner js-file-line">self-management	tự chủ</td>
        <td id="LC365" class="blob-code blob-code-inner js-file-line">seminal	hội nghị</td>
        <td id="LC366" class="blob-code blob-code-inner js-file-line">sentence	bản án</td>
        <td id="LC367" class="blob-code blob-code-inner js-file-line">sentenced prisoner	tù nhân đã bị kết án</td>
        <td id="LC368" class="blob-code blob-code-inner js-file-line">Separation	Cách ly</td>
        <td id="LC369" class="blob-code blob-code-inner js-file-line">sequencing, intensity and duration	chuỗi (trong di truyền học), độ mạnh và thời luợng</td>
        <td id="LC370" class="blob-code blob-code-inner js-file-line">serial arsonist	kẻ phóng hỏa hàng loạt</td>
        <td id="LC371" class="blob-code blob-code-inner js-file-line">seriousness of the offence	mức độ vi phạm</td>
        <td id="LC372" class="blob-code blob-code-inner js-file-line">Sex Discrimination Act	Đạo luật phân biệt giới tính</td>
        <td id="LC373" class="blob-code blob-code-inner js-file-line">sex offender	tội phạm tình dục</td>
        <td id="LC374" class="blob-code blob-code-inner js-file-line">sex offender rehabilitation programme	chương trình cải tạo tội phạm tình dục</td>
        <td id="LC375" class="blob-code blob-code-inner js-file-line">Sex Offender Treatment Programme (SOTP)	Chương trình điều trị cho tội phạm tình dục</td>
        <td id="LC376" class="blob-code blob-code-inner js-file-line">sex offending	quấy rối tình dục</td>
        <td id="LC377" class="blob-code blob-code-inner js-file-line">Sexual abuse	lạm dụng tình dục</td>
        <td id="LC378" class="blob-code blob-code-inner js-file-line">sexual behaviour	hành vi tình dục</td>
        <td id="LC379" class="blob-code blob-code-inner js-file-line">sexual fantasies	những tưởng tượng tinh dục</td>
        <td id="LC380" class="blob-code blob-code-inner js-file-line">sexual interests	sở thích tình dục</td>
        <td id="LC381" class="blob-code blob-code-inner js-file-line">sexual victimization	nạn nhân hoá tình dục</td>
        <td id="LC382" class="blob-code blob-code-inner js-file-line">show-up	sự lộ diện</td>
        <td id="LC383" class="blob-code blob-code-inner js-file-line">sketch	bản phác thảo</td>
        <td id="LC384" class="blob-code blob-code-inner js-file-line">skew	làm trệch</td>
        <td id="LC385" class="blob-code blob-code-inner js-file-line">Skillstreaming	tuyến kỹ năng</td>
        <td id="LC386" class="blob-code blob-code-inner js-file-line">solicitor	cố vấn pháp lý</td>
        <td id="LC387" class="blob-code blob-code-inner js-file-line">sound judgement	khả năng đánh giá tình huống hoặc hoàn cảnh một cách sắc sảo và rút ra kết luận</td>
        <td id="LC388" class="blob-code blob-code-inner js-file-line">spatial	không gian</td>
        <td id="LC389" class="blob-code blob-code-inner js-file-line">Statement Validity Assessment	Đánh giá Tính hiệu lực của Báo cáo</td>
        <td id="LC390" class="blob-code blob-code-inner js-file-line">Statements	sư bày tỏ, tường thuật</td>
        <td id="LC391" class="blob-code blob-code-inner js-file-line">statistical	thống kê</td>
        <td id="LC392" class="blob-code blob-code-inner js-file-line">Stereotypical	Khuôn mẫu</td>
        <td id="LC393" class="blob-code blob-code-inner js-file-line">stressor	Tác nhân ứng suất</td>
        <td id="LC394" class="blob-code blob-code-inner js-file-line">stressors	căng thẳng</td>
        <td id="LC395" class="blob-code blob-code-inner js-file-line">strive	phấn đấu, cố gắng</td>
        <td id="LC396" class="blob-code blob-code-inner js-file-line">subculture	tiểu văn hóa</td>
        <td id="LC397" class="blob-code blob-code-inner js-file-line">substance abuse	lạm dụng chất gây nghiện</td>
        <td id="LC398" class="blob-code blob-code-inner js-file-line">supervision	sự giám sát</td>
        <td id="LC399" class="blob-code blob-code-inner js-file-line">Supreme Court	Tòa án Tối cao</td>
        <td id="LC400" class="blob-code blob-code-inner js-file-line">suspect	nghi phạm</td>
        <td id="LC401" class="blob-code blob-code-inner js-file-line">Suspicious	khả nghi, đáng ngờ</td>
        <td id="LC402" class="blob-code blob-code-inner js-file-line">target object	mục tiêu, đối tượng nhắm đến</td>
        <td id="LC403" class="blob-code blob-code-inner js-file-line">testify	làm chứng, khai, xác/chứng nhận</td>
        <td id="LC404" class="blob-code blob-code-inner js-file-line">The Aggression Replacement Training programme (ART)	Chương trình Huấn luyện Thay đổi Hành vi Bạo lực/ Tính bạo lực</td>
        <td id="LC405" class="blob-code blob-code-inner js-file-line">the attorney general	Bộ tư pháp</td>
        <td id="LC406" class="blob-code blob-code-inner js-file-line">the Conqueror&#39;s invasion	cuộc xâm lăng của Conqueror</td>
        <td id="LC407" class="blob-code blob-code-inner js-file-line">the crime of rape	tội hiếp dâm</td>
        <td id="LC408" class="blob-code blob-code-inner js-file-line">the government commissioned	chính phủ ủy quyền</td>
        <td id="LC409" class="blob-code blob-code-inner js-file-line">The Home Office	Bộ Nội Vụ</td>
        <td id="LC410" class="blob-code blob-code-inner js-file-line">the legal point	quan điểm pháp lý</td>
        <td id="LC411" class="blob-code blob-code-inner js-file-line">The National Society for the Prevention of Cruelty to Children (NSPCC)	Hiệp hội Phòng chống ngược đãi trẻ em Anh</td>
        <td id="LC412" class="blob-code blob-code-inner js-file-line">the precision	sự chính xác</td>
        <td id="LC413" class="blob-code blob-code-inner js-file-line">The Psychology of Person Identiﬁcation	Tâm lý học xác định danh tính</td>
        <td id="LC414" class="blob-code blob-code-inner js-file-line">The rehabilation of offenders	Cải tạo phạm nhân</td>
        <td id="LC415" class="blob-code blob-code-inner js-file-line">the responsivity principal	Nguyên tắc đáp ứng</td>
        <td id="LC416" class="blob-code blob-code-inner js-file-line">The risk principle	Nguyên tắc nguy cơ</td>
        <td id="LC417" class="blob-code blob-code-inner js-file-line">The Sexual Offences Act	Luật vi phạm tình dục</td>
        <td id="LC418" class="blob-code blob-code-inner js-file-line">Threshold	ngưỡng</td>
        <td id="LC419" class="blob-code blob-code-inner js-file-line">Thug	kẻ cướp; côn đồ, du côn, ác ôn</td>
        <td id="LC420" class="blob-code blob-code-inner js-file-line">timescale	thang thời gian</td>
        <td id="LC421" class="blob-code blob-code-inner js-file-line">to underpin modern criminal pschology	làm cơ ở cho TLHT hiện đại</td>
        <td id="LC422" class="blob-code blob-code-inner js-file-line">tough on crime	xử phạm tội phạm rất nặng</td>
        <td id="LC423" class="blob-code blob-code-inner js-file-line">traumatic	(tính) sang chấn</td>
        <td id="LC424" class="blob-code blob-code-inner js-file-line">treat	xử lí</td>
        <td id="LC425" class="blob-code blob-code-inner js-file-line">trial	phiên tòa</td>
        <td id="LC426" class="blob-code blob-code-inner js-file-line">trigger off	khởi sự</td>
        <td id="LC427" class="blob-code blob-code-inner js-file-line">typology	hệ thống các loại hình</td>
        <td id="LC428" class="blob-code blob-code-inner js-file-line">umbrella term	thuật ngữ mang tính khái quát</td>
        <td id="LC429" class="blob-code blob-code-inner js-file-line">underpinning	nền tảng</td>
        <td id="LC430" class="blob-code blob-code-inner js-file-line">undetected	không bị phát giác</td>
        <td id="LC431" class="blob-code blob-code-inner js-file-line">US Department of Justice	Bộ Tư pháp Hoa Kỳ</td>
        <td id="LC432" class="blob-code blob-code-inner js-file-line">utilitarianism	thuyết vị lợi (hành động phải được đánh giá theo sự có ích cho đa số</td>
        <td id="LC433" class="blob-code blob-code-inner js-file-line">utilization	sự tận dụng</td>
        <td id="LC434" class="blob-code blob-code-inner js-file-line">vagina	âm đạo</td>
        <td id="LC435" class="blob-code blob-code-inner js-file-line">victim	nạn nhân</td>
        <td id="LC436" class="blob-code blob-code-inner js-file-line">victimization	sự ngược đãi/ sự biến thành nạn nhân</td>
        <td id="LC437" class="blob-code blob-code-inner js-file-line">vulnerabilities	những nhược điểm</td>
        <td id="LC438" class="blob-code blob-code-inner js-file-line">witness	nhân chứng</td>
        <td id="LC439" class="blob-code blob-code-inner js-file-line">witnesses&#39;s accounts	biên bản khai của người làm chứng</td>
        <td id="LC440" class="blob-code blob-code-inner js-file-line">wriggle	quanh co</td>
        <td id="LC441" class="blob-code blob-code-inner js-file-line">wrongdoer	người phạm pháp</td>
